1   A   X X X   E F G 
2   X   B C D   E F G 
3   A   B C D   E F G 
4   X   B C D   E F G 
5   A   B C D   E F G 
6   A   B C D   E F G 
7   A   B C D   E F G 
8   A   B C D   E F G 
9   A   B C D   E F G 
10  A   B C D   E F G 
